NO ./textures/default/red_brick.xpm
SO ./textures/default/green_brick.xpm
WE ./textures/default/blue_brick.xpm
EA ./textures/default/purple_brick.xpm

F 220,100,0
C 225,30,0

        1111111111111111111111111111111111
        1000000000110000000000001     1001
        1011000001110000000000001111111111
        1001000000000000000000001
111111111011000001110000000000001
100000000011000001111111111111111
111101111111110111001   100010001
111101111111110111011111100011111
11000000110101011100000010001
10000000000000001100000000001
10000000000000001101010010001
11000001110101011111011110N0111
11110111 1110101 101111010001
11111111 1111111 111111111111
                             
                             
                             
