NO ./textures/default/red_brick.xpm
SO ./textures/default/green_brick.xpm
WE ./textures/default/blue_brick.xpm
EA ./textures/default/purple_brick.xpm

F 0,0,0
C 0,0,0

11111      11111
10001      10001
10N01      10 01
10001      10001
11111      11111
