NO ./textures/default/red_brick.xpm
SO ./textures/default/green_brick.xpm
WE ./textures/default/blue_brick.xpm
EA ./textures/default/purple_brick.xpm

F 0,0,0
C 0,0,0

11111
1000111111
10N0 00001
1000111111
11111
